../pokeemerald_egg/data/maps/LilycoveCity_DepartmentStoreElevator/scripts.inc:9:	copyvar VAR_0x8005, VAR_DEPT_STORE_FLOOR
../pokeemerald_egg/data/maps/LilycoveCity_DepartmentStoreElevator/scripts.inc:63:	compare VAR_DEPT_STORE_FLOOR, DEPT_STORE_FLOORNUM_1F
../pokeemerald_egg/data/maps/LilycoveCity_DepartmentStoreElevator/scripts.inc:66:	setvar VAR_DEPT_STORE_FLOOR, DEPT_STORE_FLOORNUM_1F
../pokeemerald_egg/data/maps/LilycoveCity_DepartmentStoreElevator/scripts.inc:73:	compare VAR_DEPT_STORE_FLOOR, DEPT_STORE_FLOORNUM_2F
../pokeemerald_egg/data/maps/LilycoveCity_DepartmentStoreElevator/scripts.inc:76:	setvar VAR_DEPT_STORE_FLOOR, DEPT_STORE_FLOORNUM_2F
../pokeemerald_egg/data/maps/LilycoveCity_DepartmentStoreElevator/scripts.inc:83:	compare VAR_DEPT_STORE_FLOOR, DEPT_STORE_FLOORNUM_3F
../pokeemerald_egg/data/maps/LilycoveCity_DepartmentStoreElevator/scripts.inc:86:	setvar VAR_DEPT_STORE_FLOOR, DEPT_STORE_FLOORNUM_3F
../pokeemerald_egg/data/maps/LilycoveCity_DepartmentStoreElevator/scripts.inc:93:	compare VAR_DEPT_STORE_FLOOR, DEPT_STORE_FLOORNUM_4F
../pokeemerald_egg/data/maps/LilycoveCity_DepartmentStoreElevator/scripts.inc:96:	setvar VAR_DEPT_STORE_FLOOR, DEPT_STORE_FLOORNUM_4F
../pokeemerald_egg/data/maps/LilycoveCity_DepartmentStoreElevator/scripts.inc:103:	compare VAR_DEPT_STORE_FLOOR, DEPT_STORE_FLOORNUM_5F
../pokeemerald_egg/data/maps/LilycoveCity_DepartmentStoreElevator/scripts.inc:106:	setvar VAR_DEPT_STORE_FLOOR, DEPT_STORE_FLOORNUM_5F
../pokeemerald_egg/data/maps/Psfbadguy1Tower_Elevator/scripts.pory:10:    copyvar(VAR_0x8006,VAR_DEPT_STORE_FLOOR)
../pokeemerald_egg/data/maps/Psfbadguy1Tower_Elevator/scripts.pory:69:    if (var(VAR_DEPT_STORE_FLOOR) == DEPT_STORE_FLOORNUM_1F)    {
../pokeemerald_egg/data/maps/Psfbadguy1Tower_Elevator/scripts.pory:73:	setvar(VAR_DEPT_STORE_FLOOR,DEPT_STORE_FLOORNUM_1F)
../pokeemerald_egg/data/maps/Psfbadguy1Tower_Elevator/scripts.pory:80:    if (var(VAR_DEPT_STORE_FLOOR) == DEPT_STORE_FLOORNUM_1F)    {
../pokeemerald_egg/data/maps/Psfbadguy1Tower_Elevator/scripts.pory:84:	setvar(VAR_DEPT_STORE_FLOOR,DEPT_STORE_FLOORNUM_1F)
../pokeemerald_egg/data/maps/Psfbadguy1Tower_Elevator/scripts.pory:91:    if (var(VAR_DEPT_STORE_FLOOR) == DEPT_STORE_FLOORNUM_1F)    {
../pokeemerald_egg/data/maps/Psfbadguy1Tower_Elevator/scripts.pory:95:	setvar(VAR_DEPT_STORE_FLOOR,DEPT_STORE_FLOORNUM_1F)
../pokeemerald_egg/data/maps/Psfbadguy1Tower_Elevator/scripts.pory:102:    if (var(VAR_DEPT_STORE_FLOOR) == DEPT_STORE_FLOORNUM_1F)    {
../pokeemerald_egg/data/maps/Psfbadguy1Tower_Elevator/scripts.pory:106:	setvar(VAR_DEPT_STORE_FLOOR,DEPT_STORE_FLOORNUM_1F)
../pokeemerald_egg/data/maps/Psfbadguy1Tower_Elevator/scripts.pory:113:    if (var(VAR_DEPT_STORE_FLOOR) == DEPT_STORE_FLOORNUM_1F)    {
../pokeemerald_egg/data/maps/Psfbadguy1Tower_Elevator/scripts.pory:117:	setvar(VAR_DEPT_STORE_FLOOR,DEPT_STORE_FLOORNUM_1F)
../pokeemerald_egg/data/maps/Psfbadguy1Tower_Elevator/scripts.pory:124:    if (var(VAR_DEPT_STORE_FLOOR) == DEPT_STORE_FLOORNUM_1F)    {
../pokeemerald_egg/data/maps/Psfbadguy1Tower_Elevator/scripts.pory:128:	setvar(VAR_DEPT_STORE_FLOOR,DEPT_STORE_FLOORNUM_1F)
../pokeemerald_egg/data/maps/Psfbadguy1Tower_Elevator/scripts.pory:135:    if (var(VAR_DEPT_STORE_FLOOR) == DEPT_STORE_FLOORNUM_1F)    {
../pokeemerald_egg/data/maps/Psfbadguy1Tower_Elevator/scripts.pory:139:	setvar(VAR_DEPT_STORE_FLOOR,DEPT_STORE_FLOORNUM_1F)
../pokeemerald_egg/data/maps/Psfbadguy1Tower_Elevator/scripts.pory:146:    if (var(VAR_DEPT_STORE_FLOOR) == DEPT_STORE_FLOORNUM_1F)    {
../pokeemerald_egg/data/maps/Psfbadguy1Tower_Elevator/scripts.pory:150:	setvar(VAR_DEPT_STORE_FLOOR,DEPT_STORE_FLOORNUM_1F)
../pokeemerald_egg/data/maps/Psfbadguy1Tower_Elevator/scripts.pory:157:    if (var(VAR_DEPT_STORE_FLOOR) == DEPT_STORE_FLOORNUM_1F)    {
../pokeemerald_egg/data/maps/Psfbadguy1Tower_Elevator/scripts.pory:161:	setvar(VAR_DEPT_STORE_FLOOR,DEPT_STORE_FLOORNUM_1F)
../pokeemerald_egg/data/maps/Psfbadguy1Tower_Elevator/scripts.inc:10:	copyvar VAR_0x8006, VAR_DEPT_STORE_FLOOR
../pokeemerald_egg/data/maps/Psfbadguy1Tower_Elevator/scripts.inc:95:	compare VAR_DEPT_STORE_FLOOR, DEPT_STORE_FLOORNUM_1F
../pokeemerald_egg/data/maps/Psfbadguy1Tower_Elevator/scripts.inc:99:	setvar VAR_DEPT_STORE_FLOOR, DEPT_STORE_FLOORNUM_1F
../pokeemerald_egg/data/maps/Psfbadguy1Tower_Elevator/scripts.inc:111:	compare VAR_DEPT_STORE_FLOOR, DEPT_STORE_FLOORNUM_1F
../pokeemerald_egg/data/maps/Psfbadguy1Tower_Elevator/scripts.inc:115:	setvar VAR_DEPT_STORE_FLOOR, DEPT_STORE_FLOORNUM_1F
../pokeemerald_egg/data/maps/Psfbadguy1Tower_Elevator/scripts.inc:127:	compare VAR_DEPT_STORE_FLOOR, DEPT_STORE_FLOORNUM_1F
../pokeemerald_egg/data/maps/Psfbadguy1Tower_Elevator/scripts.inc:131:	setvar VAR_DEPT_STORE_FLOOR, DEPT_STORE_FLOORNUM_1F
../pokeemerald_egg/data/maps/Psfbadguy1Tower_Elevator/scripts.inc:143:	compare VAR_DEPT_STORE_FLOOR, DEPT_STORE_FLOORNUM_1F
../pokeemerald_egg/data/maps/Psfbadguy1Tower_Elevator/scripts.inc:147:	setvar VAR_DEPT_STORE_FLOOR, DEPT_STORE_FLOORNUM_1F
../pokeemerald_egg/data/maps/Psfbadguy1Tower_Elevator/scripts.inc:159:	compare VAR_DEPT_STORE_FLOOR, DEPT_STORE_FLOORNUM_1F
../pokeemerald_egg/data/maps/Psfbadguy1Tower_Elevator/scripts.inc:163:	setvar VAR_DEPT_STORE_FLOOR, DEPT_STORE_FLOORNUM_1F
../pokeemerald_egg/data/maps/Psfbadguy1Tower_Elevator/scripts.inc:175:	compare VAR_DEPT_STORE_FLOOR, DEPT_STORE_FLOORNUM_1F
../pokeemerald_egg/data/maps/Psfbadguy1Tower_Elevator/scripts.inc:179:	setvar VAR_DEPT_STORE_FLOOR, DEPT_STORE_FLOORNUM_1F
../pokeemerald_egg/data/maps/Psfbadguy1Tower_Elevator/scripts.inc:191:	compare VAR_DEPT_STORE_FLOOR, DEPT_STORE_FLOORNUM_1F
../pokeemerald_egg/data/maps/Psfbadguy1Tower_Elevator/scripts.inc:195:	setvar VAR_DEPT_STORE_FLOOR, DEPT_STORE_FLOORNUM_1F
../pokeemerald_egg/data/maps/Psfbadguy1Tower_Elevator/scripts.inc:207:	compare VAR_DEPT_STORE_FLOOR, DEPT_STORE_FLOORNUM_1F
../pokeemerald_egg/data/maps/Psfbadguy1Tower_Elevator/scripts.inc:211:	setvar VAR_DEPT_STORE_FLOOR, DEPT_STORE_FLOORNUM_1F
../pokeemerald_egg/data/maps/Psfbadguy1Tower_Elevator/scripts.inc:223:	compare VAR_DEPT_STORE_FLOOR, DEPT_STORE_FLOORNUM_1F
../pokeemerald_egg/data/maps/Psfbadguy1Tower_Elevator/scripts.inc:227:	setvar VAR_DEPT_STORE_FLOOR, DEPT_STORE_FLOORNUM_1F
../pokeemerald_egg/src/field_specials.c:1822:    VarSet(VAR_DEPT_STORE_FLOOR, deptStoreFloor);
../pokeemerald_egg/include/constants/vars.h:86:#define VAR_DEPT_STORE_FLOOR                 0x4043
../pokeemerald_egg/berry_fix/payload/include/constants/vars.h:67:#define VAR_DEPT_STORE_FLOOR       0x4043
